#    Linux
linux-headers
v4l2loopback-dkms               -> For virtual camera

#    Enternet
networkmanager                  -> интернет
network-manager-applet          -> Граф. штука для интернета

#    Audio
pipewire-pulse
pamixer

#    Media
vlc
gwenview

kdeconnect

#    For DE
xorg-server                     -> Иксы
xorg-xinit                      -> Запуск исков
xorg-xrandr                     -> Конфигурация мониторов
xorg-xsetroot                   -> Для отображения мыши
feh                             -> Обои/просмотрщик изображений
bspwm                           -> Оконный менеджер
sxhkd                           -> Хоткеи
polybar                         -> Панелька
rofi                            -> Запуск всякого
rofi-greenclip                  -> rofi
rofi-calc                       -> rofi
xkb-switch                      -> rofi
surfraw                         -> rofi

#    File manager
ranger                          -> File manager in console
ueberzug                        -> Looking images in ranger
atool                           -> Work with archive
mediainfo                       -> Getting techical inf about audio/video
highlight                       -> ranger?
ffmpegthumbnailer               -> pre-picture in media
zip                             -> Архиватор
unzip                           -> Разархиватор

#   Other For DE
numlockx                        -> Nulock on
xautolock                       -> Выполняет команду через время
slock                           -> блокировщик экрана
dunst                           -> Демон уведомлений
jq                              -> штука для sup+a
picom                           -> прозрачность приложений
xdotool                         -> Искуственно тыкает команду
imagemagick                     -> Форматирует фоточки


#	Terminal+Shell
zsh                             -> Zsh
oh-my-zsh-git                   -> Framework zsh
zsh-autosuggestions             -> Auto suggest previous commands
zsh-syntax-highlighting         -> Highlighting syntax
zsh-theme-powerlevel10k-git     -> Zsh theme
micro                           -> Console text editor

#	Common application
firefox                         -> Browser
telegram-desktop-bin            -> Messenger
flameshot                       -> Screenshoter
keepassxc                       -> Password manager
electrum                        -> Bitcoin wallpaper
obs-studio                      -> Streaming/Recorder software
kdenlive                        -> Video editor
krita                           -> Graphical editor
zathura                         -> File viewer
zathura-pdf-poppler             -> Addon to zathura for view PDF

#	Console application
neofetch                        -> Кросивое
htop                            -> Интересное
genact                          -> Хитрое1
cmatrix                         -> Хитрое2
cointop                         -> Курсики
translate-shell                 -> Переводчик

#	For developing
nvim                            -> IDE
python                          -> Python compilator
python-poetry                   -> Packages manager for python
python-virtualenv               -> Virtual zone for py-packages
nodejs
npm
sqlitestudio                    -> Для работы с базой sqlite

#	Fonts
ttf-material-design-icons-git
ttf-typicons
ttf-liberation
ttf-font-awesome-4
ttf-jetbrains-mono
ttf-ubuntu-font-family
ttf-dejavu
ttf-nerd-fonts-symbols
ttf-opensans 
terminus-font-ttf
noto-fonts-cjk
noto-fonts-emoji
noto-fonts
